NO ./assets/textures/north.xpm
SO ./assets/textures/south.xpm
WE ./assets/textures/west.xpm
EA ./assets/textures/east.xpm

F 220,100,0
C 120,180,255

1111111111111111111111111
1N00000000000100000000001
1110111111101010111111101
1000100000101010000010001
1011101110101011111010111
1010001010101000001010001
1010111010101111101011101
1010000010001000101000101
1011111011111010101110101
1000001000000010100010101
1111101011111110111010101
1000101000000010000010101
1011101111111011111110101
1010000000001000000010001
1010111111101111111011111
1010000000100000001000001
1011111110111111101111101
1000000010000000100000001
1111111111111111111111111
